111111
1P0111
111011
1C0E11
111111
