11111111111111
1P00C000000001
1000C000000001
1000000C000001
10000000000001
1000000C0000E1
11111111110001
