11111111111111
1P00C100000001
1000C100000001
1000010C100001
11110001110001
1000001C0000E1
11111111111111
