11111111111
1P0C00100C1
11111010101
100C1010101
10001010101
100000000E1
11111111111
